Rank,Team,G,W-L,RuFD,PaFD,PnFD,FD
1,UIW (Southland),14,12-2,147,205,22,374
2,Sacramento St. (Big Sky),13,12-1,190,153,25,368
3,Fordham (Patriot),12,9-3,130,208,19,357
4,Montana St. (Big Sky),14,12-2,217,111,19,347
5,Richmond (CAA),13,9-4,112,188,14,314
6,Samford (SoCon),13,11-2,132,164,16,312
7,Jackson St. (SWAC),13,12-1,101,182,28,311
8,Gardner-Webb (Big South),13,7-6,130,149,28,307
9,North Dakota St. (MVFC),15,12-3,197,91,17,305
9,South Dakota St. (MVFC),15,14-1,147,137,21,305
11,Delaware (CAA),13,8-5,114,166,23,303
12,Montana (Big Sky),13,8-5,129,143,25,297
13,Southeastern La. (Southland),13,9-4,138,137,16,291
13,Weber St. (Big Sky),13,10-3,138,126,27,291
15,Holy Cross (Patriot),13,12-1,145,110,33,288
16,William & Mary (CAA),13,11-2,166,97,22,285
17,Southeast Mo. St. (OVC),12,9-3,131,137,14,282
18,Furman (SoCon),13,10-3,135,124,22,281
19,N.C. Central (MEAC),12,10-2,129,124,20,273
20,Idaho (Big Sky),12,7-5,114,141,17,272
20,Western Caro. (SoCon),11,6-5,115,141,16,272
22,Bryant (Big South),11,4-7,77,167,26,270
22,Davidson (Pioneer),12,8-4,201,52,17,270
22,New Hampshire (CAA),13,9-4,97,143,30,270
25,UC Davis (Big Sky),11,6-5,109,146,10,265
26,Eastern Ky. (ASUN),12,7-5,73,179,10,262
27,UNI (MVFC),11,6-5,99,149,13,261
28,North Dakota (MVFC),12,7-5,110,131,15,256
29,Mercer (SoCon),11,7-4,103,140,10,253
30,Southern Ill. (MVFC),11,5-6,86,133,32,251
31,Austin Peay (ASUN),11,7-4,115,113,21,249
32,Saint Francis (PA) (NEC),12,9-3,107,127,14,248
33,Sacred Heart (NEC),11,5-6,108,112,26,246
34,Monmouth (CAA),11,5-6,115,109,21,245
35,UAlbany (CAA),11,3-8,77,133,31,241
36,Campbell (Big South),11,5-6,98,122,19,239
36,Northern Ariz. (Big Sky),11,3-8,80,139,20,239
38,Chattanooga (SoCon),11,7-4,84,135,16,235
39,Cal Poly (Big Sky),11,2-9,68,152,14,234
40,Portland St. (Big Sky),11,4-7,114,96,23,233
41,UT Martin (OVC),11,7-4,86,125,21,232
42,Elon (CAA),12,8-4,93,124,14,231
42,Nicholls (Southland),11,3-8,103,109,19,231
44,Florida A&M (SWAC),11,9-2,72,140,18,230
44,Southern U. (SWAC),12,7-5,122,94,14,230
46,Howard (MEAC),11,5-6,91,113,25,229
47,Alabama A&M (SWAC),11,4-7,91,112,25,228
47,Georgetown (Patriot),11,2-9,62,151,15,228
47,Jacksonville St. (ASUN),11,9-2,138,70,20,228
50,Abilene Christian (WAC),11,7-4,84,123,20,227
50,Kennesaw St. (ASUN),11,5-6,139,67,21,227
50,Youngstown St. (MVFC),11,7-4,114,94,19,227
53,Butler (Pioneer),11,7-4,112,101,12,225
53,Northern Colo. (Big Sky),11,3-8,89,114,22,225
55,Duquesne (NEC),11,4-7,80,113,31,224
55,Eastern Wash. (Big Sky),11,3-8,88,125,11,224
55,Northwestern St. (Southland),11,4-7,73,135,16,224
58,SFA (ASUN),11,6-5,99,110,12,221
59,Rhode Island (CAA),11,7-4,89,111,20,220
59,Valparaiso (Pioneer),12,5-7,79,115,26,220
61,Prairie View (SWAC),11,6-5,128,73,17,218
61,Tennessee Tech (OVC),11,4-7,100,103,15,218
63,North Ala. (ASUN),11,1-10,115,82,20,217
64,Brown (Ivy League),10,3-7,73,113,29,215
65,Central Ark. (ASUN),11,5-6,89,110,15,214
66,Towson (CAA),11,6-5,116,86,11,213
67,Dayton (Pioneer),11,8-3,123,62,25,210
68,Maine (CAA),11,2-9,86,109,14,209
68,Missouri St. (MVFC),11,5-6,85,112,12,209
70,ETSU (SoCon),11,3-8,97,92,18,207
71,Bethune-Cookman (SWAC),11,2-9,81,103,21,205
72,Central Conn. St. (NEC),11,2-9,101,86,17,204
72,LIU (NEC),11,4-7,78,107,19,204
74,Alcorn (SWAC),11,5-6,100,83,20,203
75,Lehigh (Patriot),11,2-9,60,122,20,202
75,Texas Southern (SWAC),11,5-6,102,82,18,202
77,Cornell (Ivy League),10,5-5,89,88,24,201
77,Princeton (Ivy League),10,8-2,73,118,10,201
79,The Citadel (SoCon),11,4-7,133,49,17,199
80,Villanova (CAA),11,6-5,108,74,16,198
81,Harvard (Ivy League),10,6-4,78,107,12,197
81,Yale (Ivy League),10,8-2,105,78,14,197
83,N.C. A&T (Big South),11,7-4,101,85,10,196
84,Alabama St. (SWAC),11,6-5,81,87,27,195
85,Lamar University (Southland),11,1-10,98,81,15,194
85,McNeese (Southland),11,4-7,108,70,16,194
87,Columbia (Ivy League),10,6-4,89,87,17,193
87,Morehead St. (Pioneer),11,2-9,70,105,18,193
87,Penn (Ivy League),10,8-2,56,121,16,193
90,Ark.-Pine Bluff (SWAC),11,3-8,84,82,26,192
91,Eastern Ill. (OVC),11,2-9,95,75,21,191
92,Hampton (CAA),11,4-7,76,93,20,189
93,Illinois St. (MVFC),11,6-5,72,97,19,188
93,Southern Utah (WAC),11,5-6,68,118,2,188
95,Idaho St. (Big Sky),11,1-10,74,95,15,184
95,Tennessee St. (OVC),11,4-7,83,88,13,184
95,Wofford (SoCon),11,3-8,62,108,14,184
98,Dartmouth (Ivy League),10,3-7,91,73,19,183
99,Stetson (Pioneer),10,4-6,49,121,11,181
100,Colgate (Patriot),11,3-8,86,76,16,178
100,South Carolina St. (MEAC),11,3-8,68,86,24,178
102,Presbyterian (Pioneer),11,1-10,66,97,14,177
103,Houston Christian (Southland),11,2-9,58,99,18,175
103,VMI (SoCon),11,1-10,59,95,21,175
105,San Diego (Pioneer),10,5-5,55,106,13,174
106,Drake (Pioneer),11,3-8,63,95,15,173
107,Marist (Pioneer),11,4-7,52,104,16,172
107,Mississippi Val. (SWAC),11,2-9,90,58,24,172
109,Charleston So. (Big South),10,2-8,56,94,21,171
109,Western Ill. (MVFC),11,0-11,63,88,20,171
111,Indiana St. (MVFC),11,2-9,69,86,14,169
112,Grambling (SWAC),11,3-8,81,55,31,167
112,Morgan St. (MEAC),11,4-7,78,64,25,167
114,Norfolk St. (MEAC),11,2-9,67,84,15,166
115,Sam Houston (WAC),9,5-4,75,70,20,165
116,Stony Brook (CAA),11,2-9,68,86,10,164
117,Delaware St. (MEAC),11,5-6,88,57,17,162
117,Murray St. (OVC),11,2-9,68,75,19,162
119,South Dakota (MVFC),11,3-8,66,84,10,160
120,Bucknell (Patriot),11,3-8,65,76,16,157
121,Wagner (NEC),11,1-10,47,86,18,151
122,Lafayette (Patriot),11,4-7,62,65,17,144
123,Robert Morris (Big South),11,0-11,38,76,25,139